42 20 [Dimensions]
0,0,1,1,1,1|100 0,0,1,1,7,1|100 0,0,1,1,7,1|100 0,0,1,1,7,1|100 0,0,1,1,7,1|100 0,0,1,1,7,1|100 0,0,1,1,7,1|100 0,0,1,1,7,1|100 0,0,1,1,7,1|100 0,0,1,1,7,1|100 0,0,1,1,7,1|100 0,0,1,1,7,1|100 0,0,1,1,7,1|100 0,0,1,1,7,1|100 0,0,1,1,7,1|100 0,0,1,1,7,1|100 0,0,1,1,7,1|100 0,0,1,1,7,1|100 0,0,1,1,7,1|100 0,0,1,1,7,9|100
0,0,1,6,1,1|100 1,2,0,0,0,0|500 2,4,0,0,0,0|500 1,2,0,0,0,0|500 2,4,0,0,0,0|500 1,2,0,0,0,0|500 2,4,0,0,0,0|500 1,2,0,0,0,0|500 2,4,0,0,0,0|500 1,2,0,0,0,0|500 2,4,0,0,0,0|500 1,2,0,0,0,0|500 2,4,0,0,0,0|500 1,2,0,0,0,0|500 2,4,0,0,0,0|500 1,2,0,0,0,0|500 2,4,0,0,0,0|500 2,4,0,0,0,0|500 2,4,0,0,0,0|500 0,0,1,1,1,9|100
0,0,1,6,1,1|100 1,2,0,0,0,0|500 2,4,0,0,0,0|500 1,2,0,0,0,0|500 2,4,0,0,0,0|500 1,2,0,0,0,0|500 2,4,0,0,0,0|500 1,2,0,0,0,0|500 2,4,0,0,0,0|500 1,2,0,0,0,0|500 2,4,0,0,0,0|500 1,2,0,0,0,0|500 2,4,0,0,0,0|500 1,2,0,0,0,0|500 2,4,0,0,0,0|500 1,2,0,0,0,0|500 2,4,0,0,0,0|500 2,4,0,0,0,0|500 2,4,0,0,0,0|500 0,0,1,1,1,9|100
0,0,1,6,1,1|100 1,2,0,0,0,0|500 2,4,0,0,0,0|500 1,2,0,0,0,0|500 2,4,0,0,0,0|500 1,2,0,0,0,0|500 2,4,0,0,0,0|500 1,2,0,0,0,0|500 2,4,0,0,0,0|500 1,2,0,0,0,0|500 2,4,0,0,0,0|500 1,2,0,0,0,0|500 2,4,0,0,0,0|500 1,2,0,0,0,0|500 2,4,0,0,0,0|500 1,2,0,0,0,0|500 2,4,0,0,0,0|500 2,4,0,0,0,0|500 2,4,0,0,0,0|500 0,0,1,1,1,9|100
0,0,1,6,1,1|100 1,2,0,0,0,0|500 2,4,0,0,0,0|500 1,2,0,0,0,0|500 2,4,0,0,0,0|500 1,2,0,0,0,0|500 2,4,0,0,0,0|500 1,2,0,0,0,0|500 2,4,0,0,0,0|500 1,2,0,0,0,0|500 2,4,0,0,0,0|500 1,2,0,0,0,0|500 2,4,0,0,0,0|500 1,2,0,0,0,0|500 2,4,0,0,0,0|500 1,2,0,0,0,0|500 2,4,0,0,0,0|500 2,4,0,0,0,0|500 2,4,0,0,0,0|500 0,0,1,1,1,9|100
0,0,1,6,1,1|100 1,2,0,0,0,0|500 2,4,0,0,0,0|500 1,2,0,0,0,0|500 2,4,0,0,0,0|500 1,2,0,0,0,0|500 2,4,0,0,0,0|500 1,2,0,0,0,0|500 2,4,0,0,0,0|500 1,2,0,0,0,0|500 2,4,0,0,0,0|500 1,2,0,0,0,0|500 2,4,0,0,0,0|500 1,2,0,0,0,0|500 2,4,0,0,0,0|500 1,2,0,0,0,0|500 2,4,0,0,0,0|500 2,4,0,0,0,0|500 2,4,0,0,0,0|500 0,0,1,1,1,9|100
0,0,1,6,1,1|100 1,2,0,0,0,0|500 2,4,0,0,0,0|500 1,2,0,0,0,0|500 2,4,0,0,0,0|500 1,2,0,0,0,0|500 2,4,0,0,0,0|500 1,2,0,0,0,0|500 2,4,0,0,0,0|500 1,2,0,0,0,0|500 2,4,0,0,0,0|500 1,2,0,0,0,0|500 2,4,0,0,0,0|500 1,2,0,0,0,0|500 2,4,0,0,0,0|500 1,2,0,0,0,0|500 2,4,0,0,0,0|500 2,4,0,0,0,0|500 2,4,0,0,0,0|500 0,0,1,1,1,9|100
0,0,1,6,1,1|100 1,2,0,0,0,0|500 2,4,0,0,0,0|500 1,2,0,0,0,0|500 2,4,0,0,0,0|500 1,2,0,0,0,0|500 2,4,0,0,0,0|500 1,2,0,0,0,0|500 2,4,0,0,0,0|500 1,2,0,0,0,0|500 2,4,0,0,0,0|500 1,2,0,0,0,0|500 2,4,0,0,0,0|500 1,2,0,0,0,0|500 2,4,0,0,0,0|500 1,2,0,0,0,0|500 2,4,0,0,0,0|500 2,4,0,0,0,0|500 2,4,0,0,0,0|500 0,0,1,1,1,9|100
0,0,1,6,1,1|100 1,2,0,0,0,0|500 2,4,0,0,0,0|500 1,2,0,0,0,0|500 2,4,0,0,0,0|500 1,2,0,0,0,0|500 2,4,0,0,0,0|500 1,2,0,0,0,0|500 2,4,0,0,0,0|500 1,2,0,0,0,0|500 2,4,0,0,0,0|500 1,2,0,0,0,0|500 2,4,0,0,0,0|500 1,2,0,0,0,0|500 2,4,0,0,0,0|500 1,2,0,0,0,0|500 2,4,0,0,0,0|500 2,4,0,0,0,0|500 2,4,0,0,0,0|500 0,0,1,1,1,9|100
0,0,1,6,1,1|100 1,2,0,0,0,0|500 2,4,0,0,0,0|500 1,2,0,0,0,0|500 2,4,0,0,0,0|500 1,2,0,0,0,0|500 2,4,0,0,0,0|500 1,2,0,0,0,0|500 2,4,0,0,0,0|500 1,2,0,0,0,0|500 2,4,0,0,0,0|500 1,2,0,0,0,0|500 2,4,0,0,0,0|500 1,2,0,0,0,0|500 2,4,0,0,0,0|500 1,2,0,0,0,0|500 2,4,0,0,0,0|500 2,4,0,0,0,0|500 2,4,0,0,0,0|500 0,0,1,1,1,9|100
0,0,1,6,1,1|100 1,2,0,0,0,0|500 2,4,0,0,0,0|500 1,2,0,0,0,0|500 2,4,0,0,0,0|500 1,2,0,0,0,0|500 2,4,0,0,0,0|500 1,2,0,0,0,0|500 2,4,0,0,0,0|500 1,2,0,0,0,0|500 2,4,0,0,0,0|500 1,2,0,0,0,0|500 2,4,0,0,0,0|500 1,2,0,0,0,0|500 2,4,0,0,0,0|500 1,2,0,0,0,0|500 2,4,0,0,0,0|500 2,4,0,0,0,0|500 2,4,0,0,0,0|500 0,0,1,1,1,9|100
0,0,1,6,1,1|100 1,2,0,0,0,0|500 2,4,0,0,0,0|500 1,2,0,0,0,0|500 2,4,0,0,0,0|500 1,2,0,0,0,0|500 2,4,0,0,0,0|500 1,2,0,0,0,0|500 2,4,0,0,0,0|500 1,2,0,0,0,0|500 2,4,0,0,0,0|500 1,2,0,0,0,0|500 2,4,0,0,0,0|500 1,2,0,0,0,0|500 2,4,0,0,0,0|500 1,2,0,0,0,0|500 2,4,0,0,0,0|500 2,4,0,0,0,0|500 2,4,0,0,0,0|500 0,0,1,1,1,9|100
0,0,1,6,1,1|100 1,2,0,0,0,0|500 2,4,0,0,0,0|500 1,2,0,0,0,0|500 2,4,0,0,0,0|500 1,2,0,0,0,0|500 2,4,0,0,0,0|500 1,2,0,0,0,0|500 2,4,0,0,0,0|500 1,2,0,0,0,0|500 2,4,0,0,0,0|500 1,2,0,0,0,0|500 2,4,0,0,0,0|500 1,2,0,0,0,0|500 2,4,0,0,0,0|500 1,2,0,0,0,0|500 2,4,0,0,0,0|500 2,4,0,0,0,0|500 2,4,0,0,0,0|500 0,0,1,1,1,9|100
0,0,1,6,1,1|100 1,2,0,0,0,0|500 2,4,0,0,0,0|500 1,2,0,0,0,0|500 2,4,0,0,0,0|500 1,2,0,0,0,0|500 2,4,0,0,0,0|500 1,2,0,0,0,0|500 2,4,0,0,0,0|500 1,2,0,0,0,0|500 2,4,0,0,0,0|500 1,2,0,0,0,0|500 2,4,0,0,0,0|500 1,2,0,0,0,0|500 2,4,0,0,0,0|500 1,2,0,0,0,0|500 2,4,0,0,0,0|500 2,4,0,0,0,0|500 2,4,0,0,0,0|500 0,0,1,1,1,9|100
0,0,1,6,1,1|100 1,2,0,0,0,0|500 2,4,0,0,0,0|500 1,2,0,0,0,0|500 2,4,0,0,0,0|500 1,2,0,0,0,0|500 2,4,0,0,0,0|500 1,2,0,0,0,0|500 2,4,0,0,0,0|500 1,2,0,0,0,0|500 2,4,0,0,0,0|500 1,2,0,0,0,0|500 2,4,0,0,0,0|500 1,2,0,0,0,0|500 2,4,0,0,0,0|500 1,2,0,0,0,0|500 2,4,0,0,0,0|500 2,4,0,0,0,0|500 2,4,0,0,0,0|500 0,0,1,1,1,9|100
0,0,1,6,1,1|100 1,2,0,0,0,0|500 2,4,0,0,0,0|500 1,2,0,0,0,0|500 2,4,0,0,0,0|500 1,2,0,0,0,0|500 2,4,0,0,0,0|500 1,2,0,0,0,0|500 2,4,0,0,0,0|500 1,2,0,0,0,0|500 2,4,0,0,0,0|500 1,2,0,0,0,0|500 2,4,0,0,0,0|500 1,2,0,0,0,0|500 2,4,0,0,0,0|500 1,2,0,0,0,0|500 2,4,0,0,0,0|500 2,4,0,0,0,0|500 2,4,0,0,0,0|500 0,0,1,1,1,9|100
0,0,1,6,1,1|100 1,2,0,0,0,0|500 2,4,0,0,0,0|500 1,2,0,0,0,0|500 2,4,0,0,0,0|500 1,2,0,0,0,0|500 2,4,0,0,0,0|500 1,2,0,0,0,0|500 2,4,0,0,0,0|500 1,2,0,0,0,0|500 2,4,0,0,0,0|500 1,2,0,0,0,0|500 2,4,0,0,0,0|500 1,2,0,0,0,0|500 2,4,0,0,0,0|500 1,2,0,0,0,0|500 2,4,0,0,0,0|500 2,4,0,0,0,0|500 2,4,0,0,0,0|500 0,0,1,1,1,9|100
0,0,1,6,1,1|100 1,2,0,0,0,0|500 2,4,0,0,0,0|500 1,2,0,0,0,0|500 2,4,0,0,0,0|500 1,2,0,0,0,0|500 2,4,0,0,0,0|500 1,2,0,0,0,0|500 2,4,0,0,0,0|500 1,2,0,0,0,0|500 2,4,0,0,0,0|500 1,2,0,0,0,0|500 2,4,0,0,0,0|500 1,2,0,0,0,0|500 2,4,0,0,0,0|500 1,2,0,0,0,0|500 2,4,0,0,0,0|500 2,4,0,0,0,0|500 2,4,0,0,0,0|500 0,0,1,1,1,9|100
0,0,1,6,1,1|100 1,2,0,0,0,0|500 2,4,0,0,0,0|500 1,2,0,0,0,0|500 2,4,0,0,0,0|500 1,2,0,0,0,0|500 2,4,0,0,0,0|500 1,2,0,0,0,0|500 2,4,0,0,0,0|500 1,2,0,0,0,0|500 2,4,0,0,0,0|500 1,2,0,0,0,0|500 2,4,0,0,0,0|500 1,2,0,0,0,0|500 2,4,0,0,0,0|500 1,2,0,0,0,0|500 2,4,0,0,0,0|500 2,4,0,0,0,0|500 2,4,0,0,0,0|500 0,0,1,1,1,9|100
0,0,1,6,1,1|100 1,2,0,0,0,0|500 2,4,0,0,0,0|500 1,2,0,0,0,0|500 2,4,0,0,0,0|500 1,2,0,0,0,0|500 2,4,6,7,8,9|100 2,4,9,6,7,8|100 2,1,1,1,1,1|300 2,4,8,9,6,7|100 2,4,7,8,9,6|100 1,2,0,0,0,0|500 2,4,0,0,0,0|500 1,2,0,0,0,0|500 2,4,0,0,0,0|500 1,2,0,0,0,0|500 2,4,0,0,0,0|500 2,4,0,0,0,0|500 2,4,0,0,0,0|500 0,0,1,1,1,9|100
0,0,1,6,1,1|100 1,2,0,0,0,0|500 2,4,0,0,0,0|500 1,2,0,0,0,0|500 2,4,0,0,0,0|500 1,2,0,0,0,0|500 2,4,9,8,7,6|100 1,4,0,0,0,0|500 1,4,0,0,0,0|500 1,4,0,0,0,0|500 2,4,6,7,8,9|100 1,2,0,0,0,0|500 2,4,0,0,0,0|500 1,2,0,0,0,0|500 2,4,0,0,0,0|500 1,2,0,0,0,0|500 2,4,0,0,0,0|500 2,4,0,0,0,0|500 2,4,0,0,0,0|500 0,0,1,1,1,9|100
0,0,1,6,1,1|100 1,2,0,0,0,0|500 2,4,0,0,0,0|500 1,2,0,0,0,0|500 2,4,0,0,0,0|500 1,2,0,0,0,0|500 2,1,1,1,1,1|300 1,4,0,0,0,0|500 1,4,0,0,0,0|500 1,4,0,0,0,0|500 2,1,1,1,1,1|300 1,2,0,0,0,0|500 2,4,0,0,0,0|500 1,2,0,0,0,0|500 2,4,0,0,0,0|500 1,2,0,0,0,0|500 2,4,0,0,0,0|500 2,4,0,0,0,0|500 2,4,0,0,0,0|500 0,0,1,1,1,9|100
0,0,1,6,1,1|100 1,2,0,0,0,0|500 2,4,0,0,0,0|500 1,2,0,0,0,0|500 2,4,0,0,0,0|500 1,2,0,0,0,0|500 2,4,6,7,8,9|100 1,4,0,0,0,0|500 1,4,0,0,0,0|500 1,4,0,0,0,0|500 2,4,6,7,8,9|100 1,2,0,0,0,0|500 2,4,0,0,0,0|500 1,2,0,0,0,0|500 2,4,0,0,0,0|500 1,2,0,0,0,0|500 2,4,0,0,0,0|500 2,4,0,0,0,0|500 2,4,0,0,0,0|500 0,0,1,1,1,9|100
0,0,1,6,1,1|100 1,2,0,0,0,0|500 2,4,0,0,0,0|500 1,2,0,0,0,0|500 2,4,0,0,0,0|500 1,2,0,0,0,0|500 2,4,6,7,8,9|100 2,4,6,7,8,9|100 2,1,1,1,1,1|300 1,4,6,7,8,9|100 2,4,6,7,8,9|100 1,2,0,0,0,0|500 2,4,0,0,0,0|500 1,2,0,0,0,0|500 2,4,0,0,0,0|500 1,2,0,0,0,0|500 2,4,0,0,0,0|500 2,4,0,0,0,0|500 2,4,0,0,0,0|500 0,0,1,1,1,9|100
0,0,1,6,1,1|100 1,2,0,0,0,0|500 2,4,0,0,0,0|500 1,2,0,0,0,0|500 2,4,0,0,0,0|500 1,2,0,0,0,0|500 2,4,0,0,0,0|500 1,2,0,0,0,0|500 2,4,0,0,0,0|500 1,2,0,0,0,0|500 2,4,0,0,0,0|500 1,2,0,0,0,0|500 2,4,0,0,0,0|500 1,2,0,0,0,0|500 2,4,0,0,0,0|500 1,2,0,0,0,0|500 2,4,0,0,0,0|500 2,4,0,0,0,0|500 2,4,0,0,0,0|500 0,0,1,1,1,9|100
0,0,1,6,1,1|100 1,2,0,0,0,0|500 2,4,0,0,0,0|500 1,2,0,0,0,0|500 2,4,0,0,0,0|500 1,2,0,0,0,0|500 2,4,0,0,0,0|500 1,2,0,0,0,0|500 2,4,0,0,0,0|500 1,2,0,0,0,0|500 2,4,0,0,0,0|500 1,2,0,0,0,0|500 2,4,0,0,0,0|500 1,2,0,0,0,0|500 2,4,0,0,0,0|500 1,2,0,0,0,0|500 2,4,0,0,0,0|500 2,4,0,0,0,0|500 2,4,0,0,0,0|500 0,0,1,1,1,9|100
0,0,1,6,1,1|100 1,2,0,0,0,0|500 2,4,0,0,0,0|500 1,2,0,0,0,0|500 2,4,0,0,0,0|500 1,2,0,0,0,0|500 2,4,0,0,0,0|500 1,2,0,0,0,0|500 2,4,0,0,0,0|500 1,2,0,0,0,0|500 2,4,0,0,0,0|500 1,2,0,0,0,0|500 2,4,0,0,0,0|500 1,2,0,0,0,0|500 2,4,0,0,0,0|500 1,2,0,0,0,0|500 2,4,0,0,0,0|500 2,4,0,0,0,0|500 2,4,0,0,0,0|500 0,0,1,1,1,9|100
0,0,1,6,1,1|100 1,2,0,0,0,0|500 2,4,0,0,0,0|500 1,2,0,0,0,0|500 2,4,0,0,0,0|500 1,2,0,0,0,0|500 2,4,0,0,0,0|500 1,2,0,0,0,0|500 2,4,0,0,0,0|500 1,2,0,0,0,0|500 2,4,0,0,0,0|500 1,2,0,0,0,0|500 2,4,0,0,0,0|500 1,2,0,0,0,0|500 2,4,0,0,0,0|500 1,2,0,0,0,0|500 2,4,0,0,0,0|500 2,4,0,0,0,0|500 2,4,0,0,0,0|500 0,0,1,1,1,9|100
0,0,1,6,1,1|100 1,2,0,0,0,0|500 2,4,0,0,0,0|500 1,2,0,0,0,0|500 2,4,0,0,0,0|500 1,2,0,0,0,0|500 2,4,0,0,0,0|500 1,2,0,0,0,0|500 2,4,0,0,0,0|500 1,2,0,0,0,0|500 2,4,0,0,0,0|500 1,2,0,0,0,0|500 2,4,0,0,0,0|500 1,2,0,0,0,0|500 2,4,0,0,0,0|500 1,2,0,0,0,0|500 2,4,0,0,0,0|500 2,4,0,0,0,0|500 2,4,0,0,0,0|500 0,0,1,1,1,9|100
0,0,1,6,1,1|100 1,2,0,0,0,0|500 2,4,0,0,0,0|500 1,2,0,0,0,0|500 2,4,0,0,0,0|500 1,2,0,0,0,0|500 2,4,0,0,0,0|500 1,2,0,0,0,0|500 2,4,0,0,0,0|500 1,2,0,0,0,0|500 2,4,0,0,0,0|500 1,2,0,0,0,0|500 2,4,0,0,0,0|500 1,2,0,0,0,0|500 2,4,0,0,0,0|500 1,2,0,0,0,0|500 2,4,0,0,0,0|500 2,4,0,0,0,0|500 2,4,0,0,0,0|500 0,0,1,1,1,9|100
0,0,1,6,1,1|100 1,2,0,0,0,0|500 2,4,0,0,0,0|500 1,2,0,0,0,0|500 2,4,0,0,0,0|500 1,2,0,0,0,0|500 2,4,0,0,0,0|500 1,2,0,0,0,0|500 2,4,0,0,0,0|500 1,2,0,0,0,0|500 2,4,0,0,0,0|500 1,2,0,0,0,0|500 2,4,0,0,0,0|500 1,2,0,0,0,0|500 2,4,0,0,0,0|500 1,2,0,0,0,0|500 2,4,0,0,0,0|500 2,4,0,0,0,0|500 2,4,0,0,0,0|500 0,0,1,1,1,9|100
0,0,1,6,1,1|100 1,2,0,0,0,0|500 2,4,0,0,0,0|500 1,2,0,0,0,0|500 2,4,0,0,0,0|500 1,2,0,0,0,0|500 2,4,0,0,0,0|500 1,2,0,0,0,0|500 2,4,0,0,0,0|500 1,2,0,0,0,0|500 2,4,0,0,0,0|500 1,2,0,0,0,0|500 2,4,0,0,0,0|500 1,2,0,0,0,0|500 2,4,0,0,0,0|500 1,2,0,0,0,0|500 2,4,0,0,0,0|500 2,4,0,0,0,0|500 2,4,0,0,0,0|500 0,0,1,1,1,9|100
0,0,1,6,1,1|100 1,2,0,0,0,0|500 2,4,0,0,0,0|500 1,2,0,0,0,0|500 2,4,0,0,0,0|500 1,2,0,0,0,0|500 2,4,0,0,0,0|500 1,2,0,0,0,0|500 2,4,0,0,0,0|500 1,2,0,0,0,0|500 2,4,0,0,0,0|500 1,2,0,0,0,0|500 2,4,0,0,0,0|500 1,2,0,0,0,0|500 2,4,0,0,0,0|500 1,2,0,0,0,0|500 2,4,0,0,0,0|500 2,4,0,0,0,0|500 2,4,0,0,0,0|500 0,0,1,1,1,9|100
0,0,1,6,1,1|100 1,2,0,0,0,0|500 2,4,0,0,0,0|500 1,2,0,0,0,0|500 2,4,0,0,0,0|500 1,2,0,0,0,0|500 2,4,0,0,0,0|500 1,2,0,0,0,0|500 2,4,0,0,0,0|500 1,2,0,0,0,0|500 2,4,0,0,0,0|500 1,2,0,0,0,0|500 2,4,0,0,0,0|500 1,2,0,0,0,0|500 2,4,0,0,0,0|500 1,2,0,0,0,0|500 2,4,0,0,0,0|500 2,4,0,0,0,0|500 2,4,0,0,0,0|500 0,0,1,1,1,9|100
0,0,1,6,1,1|100 1,2,0,0,0,0|500 2,4,0,0,0,0|500 1,2,0,0,0,0|500 2,4,0,0,0,0|500 1,2,0,0,0,0|500 2,4,0,0,0,0|500 1,2,0,0,0,0|500 2,4,0,0,0,0|500 1,2,0,0,0,0|500 2,4,0,0,0,0|500 1,2,0,0,0,0|500 2,4,0,0,0,0|500 1,2,0,0,0,0|500 2,4,0,0,0,0|500 1,2,0,0,0,0|500 2,4,0,0,0,0|500 2,4,0,0,0,0|500 2,4,0,0,0,0|500 0,0,1,1,1,9|100
0,0,1,6,1,1|100 1,2,0,0,0,0|500 2,4,0,0,0,0|500 1,2,0,0,0,0|500 2,4,0,0,0,0|500 1,2,0,0,0,0|500 2,4,0,0,0,0|500 1,2,0,0,0,0|500 2,4,0,0,0,0|500 1,2,0,0,0,0|500 2,4,0,0,0,0|500 1,2,0,0,0,0|500 2,4,0,0,0,0|500 1,2,0,0,0,0|500 2,4,0,0,0,0|500 1,2,0,0,0,0|500 2,4,0,0,0,0|500 2,4,0,0,0,0|500 2,4,0,0,0,0|500 0,0,1,1,1,9|100
0,0,1,6,1,1|100 1,2,0,0,0,0|500 2,4,0,0,0,0|500 1,2,0,0,0,0|500 2,4,0,0,0,0|500 1,2,0,0,0,0|500 2,4,0,0,0,0|500 1,2,0,0,0,0|500 2,4,0,0,0,0|500 1,2,0,0,0,0|500 2,4,0,0,0,0|500 1,2,0,0,0,0|500 2,4,0,0,0,0|500 1,2,0,0,0,0|500 2,4,0,0,0,0|500 1,2,0,0,0,0|500 2,4,0,0,0,0|500 2,4,0,0,0,0|500 2,4,0,0,0,0|500 0,0,1,1,1,9|100
0,0,1,6,1,1|100 1,2,0,0,0,0|500 2,4,0,0,0,0|500 1,2,0,0,0,0|500 2,4,0,0,0,0|500 1,2,0,0,0,0|500 2,4,0,0,0,0|500 1,2,0,0,0,0|500 2,4,0,0,0,0|500 1,2,0,0,0,0|500 2,4,0,0,0,0|500 1,2,0,0,0,0|500 2,4,0,0,0,0|500 1,2,0,0,0,0|500 2,4,0,0,0,0|500 1,2,0,0,0,0|500 2,4,0,0,0,0|500 2,4,0,0,0,0|500 2,4,0,0,0,0|500 0,0,1,1,1,9|100
0,0,1,6,1,1|100 1,2,0,0,0,0|500 2,4,0,0,0,0|500 1,2,0,0,0,0|500 2,4,0,0,0,0|500 1,2,0,0,0,0|500 2,4,0,0,0,0|500 1,2,0,0,0,0|500 2,4,0,0,0,0|500 1,2,0,0,0,0|500 2,4,0,0,0,0|500 1,2,0,0,0,0|500 2,4,0,0,0,0|500 1,2,0,0,0,0|500 2,4,0,0,0,0|500 1,2,0,0,0,0|500 2,4,0,0,0,0|500 2,4,0,0,0,0|500 2,4,0,0,0,0|500 0,0,1,1,1,9|100
0,0,1,6,1,1|100 1,2,0,0,0,0|500 2,4,0,0,0,0|500 1,2,0,0,0,0|500 2,4,0,0,0,0|500 1,2,0,0,0,0|500 2,4,0,0,0,0|500 1,2,0,0,0,0|500 2,4,0,0,0,0|500 1,2,0,0,0,0|500 2,4,0,0,0,0|500 1,2,0,0,0,0|500 2,4,0,0,0,0|500 1,2,0,0,0,0|500 2,4,0,0,0,0|500 1,2,0,0,0,0|500 2,4,0,0,0,0|500 2,4,0,0,0,0|500 2,4,0,0,0,0|500 0,0,1,1,1,9|100
0,0,1,6,1,1|100 1,2,0,0,0,0|500 2,4,0,0,0,0|500 1,2,0,0,0,0|500 2,4,0,0,0,0|500 1,2,0,0,0,0|500 2,4,0,0,0,0|500 1,2,0,0,0,0|500 2,4,0,0,0,0|500 1,2,0,0,0,0|500 2,4,0,0,0,0|500 1,2,0,0,0,0|500 2,4,0,0,0,0|500 1,2,0,0,0,0|500 2,4,0,0,0,0|500 1,2,0,0,0,0|500 2,4,0,0,0,0|500 2,4,0,0,0,0|500 2,4,0,0,0,0|500 0,0,1,1,1,9|100
0,0,1,1,1,1|100 0,0,8,1,1,1|100 0,0,8,1,1,1|100 0,0,8,1,1,1|100 0,0,8,1,1,1|100 0,0,8,1,1,1|100 0,0,8,1,1,1|100 0,0,8,1,1,1|100 0,0,8,1,1,1|100 0,0,8,1,1,1|100 0,0,8,1,1,1|100 0,0,8,1,1,1|100 0,0,8,1,1,1|100 0,0,8,1,1,1|100 0,0,8,1,1,1|100 0,0,8,1,1,1|100 0,0,8,1,1,1|100 0,0,8,1,1,1|100 0,0,8,1,1,1|100 0,0,8,1,1,1|100
